orsNew Music Friday 5/7/21 LyricsHigher Power - Coldplay
What You Need - Don Toliver
Miss The Rage (feat. Playboi Carti) - Trippie Redd
i n t e r l u d e - J. Cole
Fast (Motion) - Saweetie
Break My Heart Myself (feat. Travis Barker) - Bebe Rexha
Run - OneRepublic
Tiempo - Ozuna
Bout Me - Coi Leray
Lay Wit Ya (feat. Duke Deuce) - Isaiah Rashad
Never Left - Lil Tecca
Astronomy - Conan Gray
All I Know So Far - P!nk
It Don‚Äôt Matter - Spotify Singles - Alok
Sideways - ILLENIUM
LVRN Cypher - Spotify Singles (feat. BRS Kash, OMB Bloodbath & NoonieVsEverybody) - Love Renaissance (LVRN)
shop (feat. DaBaby) - Toosii
7 De Mayo - J Balvin
Astronaut In The Ocean (Remix) - feat. G-Eazy & DDG - Masked Wolf
hollywood sucks// - KennyHoopla
Like That - JP Saxe
Me Without You - Ashe
Mess It Up - Gracie Abrams
I Only Love You When I'm Sad - Lillian Hepler
Know Me Again (with Cate) - Cian Ducrot
SMALL TALK - Russ
In My Feelings (feat. Quavo & Young Dolph) - Tee Grizzley
Woman - Little Simz
A-O-K - Tai Verdes
the long way home (feat. Sarcastic Sounds & Sara Kays) - Powfu
Bodybag - chloe moriondo
Talking to Myself - Rag'n'Bone Man
Outside - Fiji Blue
Feel Something - Joshua Bassett
Xcxoplex (with Charli XCX) - A. G. Cook
Lean On Me - Cheat Codes
Hello Baby feat. Fivio Foreign - Young M.A
Perfect Timing - YG
A Million Cash Race - Babyface Ray üïí
Forevermore - Cuco
Balcony - Dayglow
We Are Between - Modest Mouse
All the Good Ones - Weezer
Streets - Kenny Chesney
Can't Miss You Anymore - Avery Anna
Lights Up (feat. Channel Tres) - Flight Facilities
Federal - SpotemGottem üïí
Thumbin - Kash Doll
Two-Step Down to Texas - Jack Ingram
Amnesia - MOD SUN
BUFF - Cochise
We Straight (feat. Vince Staples) - ALLBLACK
Through The Storm - Don Diablo
Last Call - Kidd G
Wait, I Lied - Alfie Templeman
From The Back of a Cab - Rostam
On Your Mind - Doss
lonely - BETWEEN FRIENDS
Worldwide - Emanuel
Mask On - Lil Poppa
Knock Knock - Nardo Wick
MILLION DOLLAR PEASANT - Melvoni
by myself - boyband
F.R.A. - REI AMI
Special Girl - dodie
Funeral (feat. James Bay) - Maisie Peters
Hold Out - Aly & AJ
Otra A Tu Salud - Carin Leon
Yamacraw Yetti - Pote Baby
winter in atlanta (feat. Russ) - Njomza
Mala De Verdad - Mariah Angeliq
Seeds - Yoke Lore
Cry & Drive - CXLOE
Love Like This - Maximillian
Dark In The Morning - Bailey Bryan
Middle of Love - Jake Wesley Rogers
I need you (to be wrong) - Switchfoot
EL TREN - Micro TDH
The Get Back - Flipp Dinero
Dem Girlz (with Erica Banks feat. Beatking) - Big Jade
Specific (feat. Duckwrth) - TeaMarrr
ISN‚ÄôT EVERYONE - HEALTH
Mirages - patchymate
REM - Mac Wetha
Prom - courtship.
so good - joan
House of Cards - Alexander Stewart
War In Your Arms - Ben Abraham
Symphony - Forester
WRONG - Marcellus Juvann üêö
What Are We? - Anayah
complicated - Amber Liu
Hypocrite - Annika Rose
Every Window Is A Mirror - Joywave
ADRENALINE - 19&YOU
3AM - payton
Too Tired - KALI
All Made Up - Squidgeni